{
  "京": 1,
  "沪": 2,
  "津": 3,
  "渝": 4,
  "冀": 5,
  "晋": 6,
  "辽": 7,
  "吉": 8,
  "黑": 9,
  "苏": 10,
  "浙": 11,
  "皖": 12,
  "闽": 13,
  "赣": 14,
  "鲁": 15,
  "豫": 16,
  "鄂": 17,
  "湘": 18,
  "粤": 19,
  "琼": 20,
  "川": 21,
  "贵": 22,
  "云": 23,
  "陕": 24,
  "甘": 25,
  "青": 26,
  "蒙": 27,
  "桂": 28,
  "宁": 29,
  "新": 30,
  "藏": 31,
  "使": 32,
  "领": 33,
  "警": 34,
  "学": 35,
  "港": 36,
  "澳": 37,
  "A": 38,
  "B": 39,
  "C": 40,
  "D": 41,
  "E": 42,
  "F": 43,
  "G": 44,
  "H": 45,
  "J": 46,
  "K": 47,
  "L": 48,
  "M": 49,
  "N": 50,
  "P": 51,
  "Q": 52,
  "R": 53,
  "S": 54,
  "T": 55,
  "U": 56,
  "V": 57,
  "W": 58,
  "X": 59,
  "Y": 60,
  "Z": 61,
  "0": 62,
  "1": 63,
  "2": 64,
  "3": 65,
  "4": 66,
  "5": 67,
  "6": 68,
  "7": 69,
  "8": 70,
  "9": 71
}